7,4,3,WangW (廢文Wang),[問卦] 到底怎樣和洋人相處？,Sat Nov  6 21:53:22 2021
0,0,0,www17010 (魯貓),[問卦] 每日記事本,Sat Nov  6 21:34:33 2021
7,2,5,james13112 (空洞),[問卦] 高速公路哪裡高速了,Sun Nov  7 07:34:40 2021
1,8,-7,kevin184550 (kevin184550),[問卦] LOL版重返榮耀,Sun Nov  7 01:12:49 2021
1,0,1,a36991069 (charming),[問卦] 用過洋洋洗髮精的都幾歲了,Sat Nov  6 23:12:09 2021
3,0,3,yangzy (亞瑟),[問卦] 疫苗一定要有期限嗎？,Sun Nov  7 00:06:23 2021
6,5,1,AgentSkye56 (大安周渝民),[問卦] 為啥小開不接受酒店妹,Sat Nov  6 21:10:15 2021
38,4,34,ray90910 (Blackbird),[問卦] 百貨公司低樓層改設男性商品會怎樣？,Sat Nov  6 22:41:52 2021
13,2,11,zxc881230 (神槍手打手槍神),[問卦] 阿嬤買的衣服太小件 要怎麼委婉的說,Sun Nov  7 08:31:05 2021
32,2,30,xpradax (燈一明一滅地 雨倏忽而至),[問卦] 智齒要在口外拔還是診所牙醫拔？,Sun Nov  7 00:28:06 2021
136,18,118,Bastille (巴士底),Re,Sat Nov  6 21:00:09 2021
2,1,1,mark999jrpan (安份坐在自己位子 ),Re,Sat Nov  6 21:30:28 2021
1,7,-6,redDest (紅紅),[問卦] 男學妹：沒有考古題的學姊比狗還不如,Sun Nov  7 01:03:13 2021
15,14,1,hbk20491 (〥夢中情一場夢〥),[新聞] 醫師娘撞翻機車肇逃 酒測值1.55 因2個小,Sat Nov  6 21:12:30 2021
6,2,4,sdamel (=ˇ=我今天看到的癒合程s),[問卦] 為什麼台男的短褲這麼長,Sat Nov  6 21:20:31 2021
15,4,11,pauljet (拜登哥不要),[問卦] 將軍百戰身名裂？,Sat Nov  6 21:57:29 2021
38,7,31,arsonlolita (蘿莉塔大魔王←男的勿約),[公告] 血流成河 水桶,Sun Nov  7 00:47:00 2021
7,1,6,slovea (廢物文組傳產學徒),[問卦] 賀！打到喬該怎麼慶祝,Sun Nov  7 00:17:51 2021
3,11,-8,agonist5566 (agonist5566),Re,Sun Nov  7 00:35:29 2021
10,5,5,horse5566lee (魅力型男★☆黃敬堯☆★),[問卦] 1996台海危機 美軍航母戰鬥群擋得住嗎？,Sat Nov  6 23:16:39 2021
3,0,3,barber (頭又大),[問卦] 現代人心靈空虛？,Sat Nov  6 23:30:36 2021
1,0,1,owo0204 (大大大優惠),Re,Sun Nov  7 04:04:35 2021
4,0,4,lianpig5566 (家庭教師殺手里包恩),Re,Sat Nov  6 23:36:02 2021
19,3,16,eddy12357 (撾撾),[爆卦] 王柏融確定續留北海道日本火腿鬥士隊~,Sun Nov  7 04:06:41 2021
22,8,14,f5110420 (TC),請問AZ第二劑間隔又改回8週原因,Sat Nov  6 22:14:57 2021
6,0,6,pinebox (pinebox),[問卦] 德州 Astroworld 音樂會擠死8個人,Sat Nov  6 21:56:09 2021
5,3,2,iphone15 (哀鳳15),[問卦] 大家都幾天一次用洗髮精洗頭？,Sat Nov  6 23:06:47 2021
3,1,2,milkBK (blitzkrieg比較低),[問卦] 呂布被封為奮威將軍還很開心是不是因為智力只有25?,Sun Nov  7 08:04:15 2021
3,0,3,med5566 (美德5566),[問卦] 你居然挑戰我每一個決議？,Sat Nov  6 21:54:03 2021
36,7,29,shiaumei (shiaumei),[問卦] 一天一杯手搖飲 幾歲開始要洗腎？？？？,Sat Nov  6 21:25:38 2021
0,4,-4,dirtygg (O口O),[問卦] 鬼哥打那什麼爛東西?,Sun Nov  7 01:06:09 2021
9,5,4,asd159g (freedom),[問卦] W為什麼是Double U,Sun Nov  7 00:03:35 2021
5,2,3,OPPAISuki (OPPAISuki),[問卦] 為什麼美國人那麼愛 Travis Scott ?? ,Sun Nov  7 00:12:11 2021
26,0,26,calibration (噓屁啊),[問卦] 體重接近身高是什麼感覺？,Sun Nov  7 06:47:24 2021
8,1,7,adsl15888 (去留),[問卦] 想快點打完BNT 第2劑可以嗎,Sun Nov  7 01:01:25 2021
3,0,3,rosefan (Rocket Queen),Re,Sat Nov  6 23:32:41 2021
9,0,9,c255120 ((￣▽￣＃)﹏﹏),[新聞] 企排》林聖恩三顆強力發球收尾 CONTI本季,Sat Nov  6 23:42:04 2021
9,1,8,hayate232 (CY),[問卦] 跡美朱里和椎名空單挑為什麼不會有反感?,Sun Nov  7 01:14:18 2021
4,3,1,elite9q (),[問卦] 好想吃泡麵喔,Sun Nov  7 00:58:40 2021
4,2,2,chenglap (無想流流星拳),Re,Sun Nov  7 07:36:43 2021
3,2,1,a1b2c3d4e5 (阿翔),[問卦] 早起看到流星算幸運嗎？,Sun Nov  7 04:19:58 2021
2,1,1,KENDO777 (KENDO777),[問卦] 女權遇到墮胎會轉彎？,Sun Nov  7 08:30:40 2021
4,0,4,peter98 (新兵),Re,Sun Nov  7 04:19:00 2021
20,4,16,Riankuo (安吸教練 我想打球),[問卦] 人在高雄旅館 樓上叫床很大聲怎麼辦==,Sun Nov  7 02:33:45 2021
2,0,2,karta328 (我不知),Re,Sat Nov  6 22:56:25 2021
10,1,9,NUMB43 (晚了~該睡了),[問卦] 假日花5.6小時打GAME會很廢嗎,Sun Nov  7 00:45:52 2021
76,10,66,pulato16 (七股哥布林),[問卦] 小米甚麼東西必買,Sat Nov  6 22:35:33 2021
4,2,2,ronnyvvang (榮尼主),Re,Sun Nov  7 01:00:58 2021
5,2,3,t32908 (ookkokk),[爆卦] 恭喜EDG成為LOL S11世界冠軍,Sun Nov  7 01:03:44 2021
3,0,3,intrepid123 (勇氣),[問卦] 曹叡是不是不要搞司馬師 就穩了？,Sun Nov  7 07:34:33 2021
1,1,0,shotholisi (呆れて白目をむく),Re,Sun Nov  7 00:36:30 2021
11,3,8,mkzkcfh (mkzk),[問卦] 大家都用什麼武器抵抗數位犯台？,Sat Nov  6 22:15:49 2021
3,6,-3,aa52189 (Winning),[問卦] 現在要被噓到XX 是不是很難？,Sun Nov  7 08:35:12 2021
2,1,1,taiwaneye (愛呆丸),[問卦] 有人也站著溜過滑梯嗎？,Sat Nov  6 23:49:26 2021
0,0,0,Yirgacheffe (守住善良),[新聞] 被中共列名制裁 外長吳釗燮：收無數祝賀,Sun Nov  7 08:55:30 2021
5,0,5,bathilda (bat),Re,Sun Nov  7 02:31:59 2021
8,5,3,louiswei1986 (禪寶寶),[問卦] 跟家人同住最不能接受什麼,Sun Nov  7 01:56:55 2021
26,4,22,kerkerson (高處不勝寒),[問卦] 周杰倫講話為什麼不會變成26口音???,Sat Nov  6 22:50:36 2021
9,2,7,Aaso (每度あり),[問卦] 現在電視是不是都不耐用阿?,Sun Nov  7 01:59:54 2021
4,7,-3,cloudlaba (小雲蟲),[爆卦] EDG獲得英雄聯盟S11世界冠軍,Sun Nov  7 01:26:23 2021
3,2,1,howard24 (中信兄弟強攻強攻),[問卦] 真的有人去星巴克喝冰沙?,Sun Nov  7 00:19:09 2021
9,2,7,h881242001 (小英),[問卦] 十號發薪 身為月光族的我該怎麼辦,Sun Nov  7 03:12:16 2021
4,0,4,circus763 (跳跳虎),[問卦] 驚! 前乃木坂46的堀未央奈也想當大學生?!,Sat Nov  6 22:24:08 2021
17,8,9,kelosh22 (22),[問卦] 中國變成世界第2大國是習近平的功勞嗎,Sun Nov  7 03:55:11 2021
2,4,-2,aall2468 (麥當當真好吃),[問卦] 麥當當很健康吧？,Sat Nov  6 21:25:17 2021
11,0,11,pauljet (拜登哥不要),Re,Sat Nov  6 20:45:58 2021
0,0,0,ZaneTrout (大谷神鱒),Re,Sun Nov  7 00:21:02 2021
4,0,4,Townshend (Pete),[問卦] 命理專家公權力可以評鑑一下嗎？,Sat Nov  6 22:36:55 2021
12,0,12,rosefan (Rocket Queen),[問卦] 淡水輕軌有很垃圾嗎？,Sat Nov  6 21:50:30 2021
29,4,25,a1005100 (dab),[問卦] 不運動用斷食法減肥有用嗎?,Sat Nov  6 20:58:59 2021
1,2,-1,AgentSkye56 (大安周渝民),[問卦] 玻璃上的霧氣我臨摹一個妳,Sun Nov  7 08:40:50 2021
2,1,1,kobe30418 (吾有上將潘鳳),[問卦] 突然想到 統神是置入廣告第一人嗎？,Sat Nov  6 22:40:59 2021
20,3,17,greenseason (綠海兒),Re,Sat Nov  6 23:35:35 2021
2,2,0,assassinASHE (幹古專用帳號),Re,Sun Nov  7 05:57:16 2021
17,1,16,voohong (SE Asia Fat Nerd),[問卦] 告白後一直看著我笑是不是沒機會了,Sun Nov  7 05:44:12 2021
5,6,-1,chan324 (北極熊),[問卦] 有一個美麗的小女孩,Sun Nov  7 04:27:52 2021
6,2,4,aa1477888 (Mika),[問卦] 巧克力冒險工廠幹嘛不完全自動化就好？,Sun Nov  7 01:29:22 2021
3,0,3,hanslins (hanslins),Re,Sat Nov  6 23:39:07 2021
12,0,12,raxxar82 ( ),Re,Sat Nov  6 21:43:39 2021
2,1,1,KINMENKING (亂世狂刀),Re,Sat Nov  6 21:20:31 2021
36,2,34,ggian123 (釣白癡&推廣tiktok專用帳),[問卦] 為啥一堆人喜歡到咖啡廳念書@@,Sun Nov  7 00:19:25 2021
21,0,21,rs6677 (-----),[問卦] 相信11月開放會AZ混打都是什麼人？,Sat Nov  6 21:36:26 2021
2,2,0,uhottle (),[問卦] 如何永久關閉talk back,Sat Nov  6 20:44:34 2021
5,0,5,badjye911 (阿三),[問卦] 奇美的包子算頂的嗎？,Sat Nov  6 22:25:54 2021
2,0,2,Hosh (排球本命),[問卦] 生小孩v.s更年期，哪個比較可怕？,Sat Nov  6 22:54:09 2021
1,0,1,YAYA6655 (YAYA),Re,Sun Nov  7 00:51:41 2021
2,0,2,liang691206 (liang691206),Re,Sun Nov  7 00:51:40 2021
6,0,6,todao (心裡有數),Re,Sun Nov  7 03:01:53 2021
0,0,0,keyesleo (),[問卦] 打中東戰爭時，神盾局到底有沒有從中幫忙,Sun Nov  7 09:01:03 2021
9,3,6,Beziehung (Beziehung),[問卦]  Costco 的管理階層討厭試吃仔嗎？,Sun Nov  7 01:10:37 2021
38,1,37,convington (台中傑森史塔森),[問卦]  楓可憐（楓花戀）大家可以嗎？,Sun Nov  7 00:42:46 2021
37,6,31,poiu716 (),[問卦] 為何最近西方媒體一直在炒作中台戰爭?,Sat Nov  6 22:11:54 2021
0,0,0,yoyoflag (武漢肺炎乃神罰天擇),Re,Sun Nov  7 02:59:20 2021
7,2,5,vovzz (隨心所欲),[問卦] 偷聞女同事的鞋子 算犯罪嗎?,Sun Nov  7 01:43:16 2021
75,9,66,cycutom (cycutom),[問卦] 新垣結衣跟錦戶亮交往了4年多耶？= =,Sun Nov  7 01:56:40 2021
6,1,5,neo5277 (I am an agent of chaos),Re,Sun Nov  7 03:00:48 2021
10,1,9,ckpioneer (風),[爆卦] 瑞莎P League當觀眾,Sun Nov  7 06:59:29 2021
6,0,6,njxmzxc (假搞),[問卦] 漫威下一次是不是要找乙武洋匡了,Sun Nov  7 00:52:42 2021
4,1,3,mingonly (甲之砒霜 乙之蜜糖),Re,Sun Nov  7 01:11:24 2021
30,30,0,lukcat (LagCat),[新聞] 蘇貞昌重回西屯玉玄宮 高喊「4個不同意，,Sun Nov  7 07:52:17 2021
2,1,1,wppw (123),[新聞] 信義區2夜店復業！正妹帥哥揪團狂歡　警,Sat Nov  6 21:54:52 2021
6,0,6,Julian9x9x9 (朱利安999),[問卦] 高進,Sat Nov  6 22:56:24 2021
7,0,7,ai770116 (東方的神秘力量),[問卦] 有沒有美國人工作比歐洲人勤勞的八卦？,Sat Nov  6 21:22:43 2021
22,3,19,zakijudelo (Zack),[問卦] 講到北歐，你會想到什麼？,Sun Nov  7 08:03:04 2021
1,0,1,j09367 (果汁仔),Re,Sat Nov  6 21:07:26 2021
7,2,5,KagamiRaito (阿喵),[問卦] 3點半麥當勞該買啥當消夜?,Sun Nov  7 03:42:17 2021
3,4,-1,ht91008 (色情狂),[問卦] 中原夜市吃甚麼最頂？,Sat Nov  6 22:11:51 2021
2,2,0,ipipwrong (Guess),[問卦] 有沒有+9逃逸的卦?!,Sun Nov  7 00:12:49 2021
3,1,2,dameontree (最愛Curry的小妹),[問卦] 恭喜我們EDG奪冠! 比賽質量實在高,Sun Nov  7 01:14:10 2021
11,2,9,ilovemami (聯絡簿教主),[問卦] 大家對中島美嘉的看法如何,Sun Nov  7 05:24:48 2021
6,0,6,TomRiddle (湯姆瑞斗),[問卦] 愛在西元前是在說永恆族嗎,Sat Nov  6 21:23:56 2021
5,4,1,FL5566 (小魯妹),[問卦] 肥子獨吃東山鴨頭 心酸畫面流出,Sun Nov  7 01:53:59 2021
175,27,148,pttsuck5566 (過氣小丑),[問卦] 各位身邊打高端的人多嗎,Sun Nov  7 06:29:54 2021
2,0,2,as9632147 (臉兒紅),Re,Sat Nov  6 22:27:22 2021
6,2,4,Josh160864 (josh),[問卦] 為什麼張家兄弟敢評論政治,Sat Nov  6 22:59:05 2021
9,0,9,rosefan (Rocket Queen),[問卦] 講到國際笑炳 你會想到什麼？,Sat Nov  6 22:34:07 2021
26,4,22,pp771017 (乾淨又衛生),[問卦] 如果台菜二世祖辦洗白宴會怎樣,Sun Nov  7 04:02:54 2021
46,15,31,Rin5566 (派屈克),Re,Sun Nov  7 01:34:15 2021
4,2,2,kingofturtle (阿司),[問卦] 現在開始看lovelive需要注意什麼？,Sat Nov  6 23:11:56 2021
1,1,0,karta328 (我不知),Re,Sat Nov  6 22:39:18 2021
12,1,11,PPAPwww (pan),[問卦] 機車是不是蠻環保的！,Sat Nov  6 22:30:16 2021
14,2,12,jabbercarl (韓哥),[問卦] 這算惡意逼車了吧？,Sun Nov  7 00:07:26 2021
5,4,1,zzzz8931 (宅男),[問卦] 波士頓輕軌有被罵垃圾嗎？,Sun Nov  7 08:02:39 2021
1,2,-1,Silent (夢想),[問卦] 玩風之谷把表功用到最頂有加分ㄇ?,Sat Nov  6 22:02:39 2021
6,0,6,chaudieuer (),[問卦] 如何反駁IKEA都念錯，憑什麼管如何唸ml,Sat Nov  6 21:11:09 2021
16,2,14,miss80423 (自宅警備員),[問卦] 茸茸鼠也太可愛了吧？,Sat Nov  6 23:07:21 2021
23,3,20,manhaspen (男人有筆),[問卦] 你住過最可怕的飯店遇到了什麼事？,Sun Nov  7 00:38:16 2021
6,2,4,sushi11 (偶像可以亂摸嗎peko),[問卦] 想問一下軍人的從業道德是什麼？,Sun Nov  7 07:36:07 2021
5,1,4,oooo (法性本寂隨緣轉),Re,Sat Nov  6 22:12:17 2021
2,0,2,ivorysoap (ivorysoap),Re,Sun Nov  7 02:19:07 2021
4,2,2,muse87131 (),[問卦] 新冠恐慌文為何常有中國用語？,Sun Nov  7 00:24:53 2021
2,1,1,bathilda (bat),[問卦] 所以西方人忽然又喜歡美聲派了嗎？,Sun Nov  7 01:32:38 2021
9,4,5,liang691206 (liang691206),[問卦] 中國為何不把全台灣人民都通緝,Sun Nov  7 02:17:14 2021
0,0,0,doro0202 (Doro),Re,Sun Nov  7 00:12:43 2021
1,1,0,VVizZ (我很窮),[問卦] 這個人是誰？,Sat Nov  6 22:52:02 2021
2,4,-2,Workforme (′‧ω‧‵),[問卦] 樂團有人在獨奏的時候其他人在想什麼？,Sat Nov  6 21:02:48 2021
9,7,2,oinmrr (南崁半仙哥),[問卦] G軟是時間管理大師嗎,Sat Nov  6 22:21:20 2021
8,1,7,lpbrother (LP哥(LP = Love & Peace)),[問卦] 英國真的沒人敢演黛安娜王妃？,Sun Nov  7 08:13:49 2021
6,4,2,Emerson158 (紅豆 X 八嘎 X 烏魯賽),[問卦] 現在口試還流行用85度溪的蛋糕請口委嗎?,Sat Nov  6 23:18:08 2021
1,3,-2,adsl15888 (去留),Re,Sun Nov  7 01:31:08 2021
3,0,3,orthogonal (謙哥),[問卦] 人類歷史上最嚴重的非疏失工程事故是甚麼,Sun Nov  7 00:47:52 2021
0,0,0,jorry111111 (andy),[問卦] 年輕女生做工地是不是趨勢,Sun Nov  7 08:54:49 2021
0,2,-2,s505015 (s505015b大),Re,Sun Nov  7 01:14:47 2021
64,2,62,GraceMa (我喜歡騎馬),[問卦] 石內卜那麼優秀為什麼甘願屈就,Sat Nov  6 22:59:23 2021
5,2,3,anger312143 (anger),[問卦] 有咖啡因神人嗎？,Sun Nov  7 00:08:58 2021
1,1,0,chen0625 (PTT47),[問卦] 是不是可以考慮第三劑了？,Sun Nov  7 00:45:08 2021
4,1,3,tony900735 (安西街教練),[問卦] 雙11+統一獅封王，7-11店員484挫咧淡？,Sat Nov  6 23:04:14 2021
6,3,3,TomRiddle (湯姆瑞斗),[問卦] 自己住的人都只穿內褲或全裸吧,Sat Nov  6 21:15:48 2021
3,4,-1,williamsf1 (Frank),[問卦] 防疫大作戰廣告找國師有加分嗎?,Sat Nov  6 21:07:35 2021
10,3,7,gogomercury (gogomercury),[問卦] 有35歲的你嗎？,Sun Nov  7 01:42:46 2021
2,0,2,jonjes (HONOKA),[問卦] 大可不要太在意期限吧？,Sun Nov  7 07:36:59 2021
6,1,5,jason3676093 (),[問卦] 開始賺錢了 還要跟女友AA嗎？,Sat Nov  6 21:34:37 2021
6,0,6,Refauth (山丘上的長號手),[問卦] 有沒有歐美街拍Youtube頻道的八卦？,Sat Nov  6 21:57:57 2021
15,15,0,jis0077 (一個人的輕旅行),[爆卦] 交通部把大型重機鑽車縫列為不良駕駛行為!,Sun Nov  7 01:00:33 2021
8,7,1,arscerate (萬與雪飄),[問卦] 台鐵鎖帳號,Sun Nov  7 00:15:44 2021
5,1,4,Qorqios (唯一威脅是紫長直☁),[問卦] 軍艦可以命名為「樓麟」嗎？,Sun Nov  7 00:13:38 2021
2,0,2,a6000200 (aa),[問卦] ptt有新文章自動推播功能嗎？,Sun Nov  7 02:13:11 2021
12,0,12,er2 (LED topic),[問卦] 到底是竹北威還是新竹市東區威？,Sat Nov  6 21:40:11 2021
5,0,5,devidevi (凱特),Re,Sat Nov  6 21:23:51 2021
67,1,66,cuba391156 (cuba391156),[問卦] 拿這運動水壺會被笑嗎？,Sat Nov  6 23:12:25 2021
1,3,-2,yuchifan (yuchi),Re,Sun Nov  7 00:55:01 2021
2,0,2,kaky (菩提本無樹明鏡亦非台),Re,Sun Nov  7 00:39:52 2021
5,3,2,cefywo (新竹結衣~* 妹妹廢文科長),[問卦] 聽說用蒟蒻打屁股很舒服,Sat Nov  6 22:24:24 2021
1,7,-6,CrazyKill (crazykill),[問卦] 對戰爭的態度，可以看出真假覺青??,Sun Nov  7 01:12:20 2021
2,1,1,mk203125 (戴奧辛),[問卦] 有沒有借車比車主凶的八卦？？？？,Sat Nov  6 21:23:12 2021
4,6,-2,utdsml (阿邊肥),[問卦] 這是單身仔最接近榮耀的時刻嗎？,Sun Nov  7 01:37:16 2021
1,0,1,a828203 (),Re,Sat Nov  6 22:00:57 2021
18,1,17,kuma525566 (毛怪),[問卦] 早安！金城武iPhone 13拿什麼顏色?,Sun Nov  7 08:18:50 2021
3,0,3,O300 (歐三百),[問卦] 各位潮潮禮拜天天要幹嘛？,Sun Nov  7 00:08:39 2021
8,1,7,takuminauki (史迪格里茲粉),[問卦] 練肌肉有助於相親嗎?,Sat Nov  6 21:41:35 2021
14,1,13,cheng135 (ya),[問卦] 日本連鎖眼鏡店大舉攻台的卦?,Sun Nov  7 00:59:02 2021
4,5,-1,redDest (紅紅),[問卦] 肥宅吃小火鍋因該開幾鍋,Sat Nov  6 22:17:16 2021
2,2,0,sofaly (沙發椅),Re,Sat Nov  6 20:58:34 2021
5,1,4,Abre (Баба-яга),Re,Sun Nov  7 00:48:20 2021
61,7,54,pchunters (pp),[問卦] 為什麼韓國歷史上，沒有進攻日本的慾望？,Sat Nov  6 22:42:27 2021
14,6,8,fraternity (聽說小新比魯夫聰明),[問卦] 為什麼台灣的餐飲業有蟲，都不用賠錢？,Sun Nov  7 00:16:31 2021
22,12,10,fack3170 (法克),[新聞] 蔡瑞雪「激美短髮」新造型曝光！網驚豔：,Sun Nov  7 07:16:44 2021
18,4,14,aventardorsv (lamborghini aventadorsv),[問卦] ☺  到底creampie是什麼意思？,Sat Nov  6 23:27:35 2021
16,7,9,Timzy (創世紀),[問卦] 其實連勝文長的蠻帥的吧？,Sat Nov  6 22:52:32 2021
7,7,0,ht91008 (色情狂),[問卦] 快兩點了，在中壢哪裡最頂？,Sun Nov  7 01:26:50 2021
3,0,3,bluebagel (果果:)),[問卦] 有燒酒雞火鍋的八卦嗎？,Sat Nov  6 21:39:32 2021
2,2,0,"god46 (大家好,我是JayJay林俊傑)",[問卦] 有沒有姐弟戀的八卦？,Sat Nov  6 20:55:24 2021
25,6,19,barber (頭又大),[問卦] 張雨生因為早逝才成為傳奇怎麼反駁？,Sat Nov  6 23:45:55 2021
14,1,13,Aaso (每度あり),[問卦] 最頂的手機是Pixel 6 pro嗎？,Sat Nov  6 23:56:05 2021
0,0,0,arsonlolita (蘿莉塔大魔王),[公告] 八卦板板規(2021.05.11),Tue May 11 15:03:06 2021
3,4,-1,lackoffuck (公車),[問卦] 分手說不出來怎麼辦,Sun Nov  7 00:19:13 2021
3,1,2,mean (低智商生活),Re,Sun Nov  7 02:04:02 2021
20,1,19,blueskymaple (你是不是在發球),[問卦] 國王排名太好看了吧！！！,Sun Nov  7 00:07:26 2021
4,10,-6,JeremyYi (啾咪易),[問卦] 政府賣的口罩質量不行,Sun Nov  7 08:05:22 2021
3,4,-1,sulanpa (...),[問卦] 只有我覺得王柏融被留下來不意外嗎？,Sun Nov  7 08:31:42 2021
1,2,-1,r2394319 (勳狗),[問卦] 有沒有保存期限的八卦,Sun Nov  7 00:20:02 2021
4,0,4,jack168168tw (陳年老魯蛇),[問卦] 有西門町獅子林大樓的八卦嗎,Sat Nov  6 23:28:39 2021
21,5,16,ga86041 (ga86041),[問卦] 分屍是件容易的事嗎?,Sun Nov  7 02:07:23 2021
30,2,28,yobaoliao071 (),[新聞] 桃園市疫苗夜間開打 基層嘆過勞,Sat Nov  6 21:25:24 2021
1,1,0,Ommmmmm5566 (有人責備我們不夠深入),Re,Sun Nov  7 00:27:56 2021
7,0,7,wester789 (皮卡丘爸),[問卦] 茶葉蛋要怎煮,Sun Nov  7 08:23:34 2021
3,1,2,andrewkuo (),[新聞] 悉尼東區超市推出人工智能結賬 自動識別,Sat Nov  6 22:01:46 2021
1,1,0,JASONBOA (jason),[問卦] 所以是要變冷了沒,Sat Nov  6 20:44:00 2021
5,4,1,disgusting (噁心的),[問卦] 怎麼寫碩士論文,Sat Nov  6 23:51:40 2021
3,1,2,NightStick (龐德任),Re,Sat Nov  6 23:09:22 2021
2,0,2,A6 (短ID真好),Re,Sat Nov  6 21:04:58 2021
2,5,-3,xxxluke (我手裡拿著小皮鞭),[問卦] 朋友在捷運上嘔吐會放生嗎？,Sun Nov  7 01:21:31 2021
7,1,6,keyesleo (),[問卦] 田中寧寧的奶，到底有沒有隆乳過,Sun Nov  7 02:29:22 2021
2,2,0,ChenDotQ (淘淘愛丟力),[問卦] 在台灣當慣竊484很爽？,Sat Nov  6 21:09:09 2021
0,0,0,Qorqios (唯一威脅是紫長直☁),Re,Sun Nov  7 00:23:51 2021
24,5,19,cj4385283 (Linhi),[問卦] +9妹比高學歷的妹子優質吧,Sat Nov  6 22:28:28 2021
5,3,2,rexlin (Some like it hot!!),[問卦] 朋友不小心在火車上睡著了(在線等),Sat Nov  6 21:25:10 2021
6,3,3,ReiFu21 (ReiFu),[問卦] 女孩會想吃肥宅嗎？,Sat Nov  6 20:52:35 2021
3,0,3,colin810106 (臺灣阿姨王),Re,Sun Nov  7 04:16:02 2021
35,6,29,EVEA (新試劑扶英戰士),高雄摩鐵驚見全裸雙屍！2人關係曝光 身旁有白粉末,Sun Nov  7 00:54:25 2021
15,2,13,Lefteye (利傅艾),[問卦] 大清愛新覺羅血親後代在日本,Sat Nov  6 21:22:17 2021
1,0,1,dk27go (可我未曾見過海洋),[問卦]  有沒有539的八卦？,Sun Nov  7 01:23:04 2021
8,7,1,w113353 (鍵盤蘿莉控),[問卦] 台南深夜飛機聲？,Sun Nov  7 01:43:51 2021
5,5,0,VVizZ (我很窮),Re,Sat Nov  6 23:19:52 2021
2,6,-4,anonymous8 (詐騙島永久居民),[問卦] 住台北多少薪水可以爽爽過,Sun Nov  7 01:34:19 2021
49,9,40,badbad (talented),[新聞] 撐不下去！23年N.Y.BAGELS　年底全停業,Sat Nov  6 22:00:57 2021
5,2,3,jason851124 (YeeeEX),[問卦] EDG = 19年NBA暴龍隊吧,Sun Nov  7 01:21:41 2021
1,2,-1,starbuckss (高雄星巴哥),[問卦] 有沒有twice的MV the feels是神曲的卦？,Sun Nov  7 01:15:15 2021
4,1,3,todao (心裡有數),[問卦] 我喜歡這樣跟著你,Sat Nov  6 21:56:41 2021
51,7,44,a555444 (是幻象?你在隱藏什麼?),[問卦] 動力火車都五十了，現場怎麼還是這麼鬼啊,Sat Nov  6 21:21:28 2021
0,2,-2,dalaba7788 (麥當老歡樂送),[問卦] 有人打完第二劑Bnt睡不著嗎,Sun Nov  7 00:23:49 2021
11,2,9,intrepid123 (勇氣),[問卦] 司馬師司馬昭 跟 曹丕曹叡 誰厲害,Sun Nov  7 01:23:59 2021
14,8,6,theskyofblue (天空藍),[問卦] 黃明志是不是現代張雨生？,Sun Nov  7 00:57:39 2021
7,0,7,yoyoflag (武漢肺炎乃神罰天擇),Re,Sat Nov  6 21:59:38 2021
2,2,0,HDSM (Love Not Change  O'_'O),[問卦] 這世界 如果有如果,Sun Nov  7 01:34:52 2021
9,3,6,aJan5566 (包金56),[問卦] 養貓都被追蹤是基本，養小孩怎麼不用？,Sat Nov  6 20:44:49 2021
4,0,4,DaiRiT (QSOFA),Re,Sat Nov  6 22:13:43 2021
8,3,5,peterlin495 (專業果粉O'_'O),[問卦] 這樣算是高CP值的披薩嗎？,Sat Nov  6 20:47:55 2021
2,0,2,elite9q (),[問卦] 哀全壘打了才把守護神換上來是甚麼操作,Sun Nov  7 00:17:01 2021
2,0,2,jojoway (FATE),Re,Sun Nov  7 08:46:32 2021
2,0,2,cycling (一直暴雷一直爽),[問卦] 為什麼騎紅黃牌的超愛改短牌和翹牌,Sun Nov  7 00:56:19 2021
7,3,4,TDOO (我最可愛),[問卦] 精？！？沒想到現在有魔趙雲了？！？,Sun Nov  7 04:16:01 2021
1,1,0,app325 (艾波),[問卦] AZ用丐的是不是才是王道？,Sun Nov  7 00:50:44 2021
9,0,9,twmadrid (chrissy我老婆),[問卦] ig上那些發財 讓你成功方式 真的嗎?,Sat Nov  6 20:52:08 2021
3,4,-1,TheAVKing (I am the AV King！),Re,Sun Nov  7 00:30:45 2021
8,2,6,xw741953 (孤獨魂),[問卦] 高雄是不是台灣第一奇城,Sat Nov  6 22:06:17 2021
4,4,0,REOLY (雷歐力),[問卦] 這是什麼金色蛾 有請昆蟲系大師,Sun Nov  7 01:03:50 2021
4,1,3,the01 (立撒),[問卦] 怎麼正確且足夠認識一個地方?,Sun Nov  7 07:45:22 2021
2,3,-1,LoveJapan (無聊),[問卦] 女友去健身房不運動坐那邊陪她她也爽？,Sat Nov  6 20:59:10 2021
18,3,15,SethBeer (SethBeer),[問卦] 郭靖到底有沒有比蕭峰、張無忌強？,Sat Nov  6 21:40:52 2021
9,5,4,ggbi4zzz (腥鮑氣流讚),[問卦] 慟！lol中國又要奪一冠了,Sun Nov  7 00:14:02 2021
0,0,0,T65K2 (T-65K2),[問卦] 日本節目是以專題取勝嗎？,Sat Nov  6 23:12:44 2021
7,0,7,how6410 (安仔),Re,Sat Nov  6 23:30:32 2021
13,1,12,moneybuy (),[問卦] 自稱金城武的是不是都老人= =,Sat Nov  6 22:55:09 2021
7,1,6,stratege (我愛風目魚),[問卦] 萊豬４８４早就進口到國內了？,Sat Nov  6 22:34:16 2021
5,2,3,pp771017 (乾淨又衛生),[問卦] 北部最頂的東山鴨頭是哪一間,Sun Nov  7 03:51:01 2021
3,1,2,YiShiJi (YISHIJI),[問卦] 上帝會阻止人類治病嗎,Sat Nov  6 20:46:57 2021
19,0,19,SethBeer (SethBeer),[問卦] 希臘為什麼鳥掉了？,Sat Nov  6 20:59:46 2021
8,8,0,realtw (realtw良心說 不比臺灣女),Re,Sun Nov  7 02:38:20 2021
1,2,-1,p69005103 (ANDY),[問卦] 火腿迷知道大王續約的第一反應?,Sun Nov  7 08:25:22 2021
3,0,3,jhbgybj123 (學店醜男),[問卦] Re,Sun Nov  7 08:45:00 2021
14,2,12,XI (MAN),[新聞] 高雄男一身名牌開400萬豪車 卻涉毒被法辦,Sat Nov  6 23:56:22 2021
20,3,17,nbarepeat (nbarepeat),[問卦] 有人決定一生不買房了嗎,Sun Nov  7 07:01:02 2021
12,2,10,s10130804 (空軍總司令),[問卦] 有人違約交割過嗎？,Sat Nov  6 20:59:51 2021
7,0,7,qazStarStar (我不是派大星),[問卦] 在高利貸上班是什麼樣的體驗？,Sun Nov  7 02:12:22 2021
3,3,0,DCARDNOBRAIN (低能卡),[問卦] pc遊戲把遊戲做成手遊然後再做成電腦板?,Sun Nov  7 04:08:18 2021
2,0,2,GraceMa (我喜歡騎馬),[問卦] 一次當很多人的工具人就不算工具了吧,Sat Nov  6 22:36:53 2021
0,0,0,a86692472 (彼得先生),[問卦] 請問創未來公司是賣高科技壺鈴的嗎？,Sat Nov  6 23:55:53 2021
3,0,3,VVizZ (我很窮),Re,Sat Nov  6 20:51:52 2021
7,4,3,abc12812 (),[問卦] 被家族放棄趕到鄉下 該怎麼半?,Sun Nov  7 06:55:05 2021
4,4,0,longyin (龍吟很難嗎？為什麼),Re,Sat Nov  6 23:01:17 2021
7,2,5,liang691206 (liang691206),Re,Sun Nov  7 00:43:47 2021
6,0,6,likeshit (大便般的存在),[問卦] 一般人要怎麼對抗通膨？,Sat Nov  6 21:20:52 2021
13,4,9,spark12 (Fly),[新聞] 不忍了！林管處控佔用天池山莊要開吉 ,Sat Nov  6 21:42:42 2021
1,0,1,Qoo2222 (Qoo2222),Re,Sat Nov  6 22:10:19 2021
11,1,10,disgusting (噁心的),[問卦] AZ不可能混BNT了吧？,Sun Nov  7 00:34:51 2021
0,1,-1,yayaya5566 (優質好文),[問卦]  如果對岸打過來全聯還會買下大潤發嗎？,Sat Nov  6 22:13:09 2021
9,1,8,ubang (把你bang不見),[問卦] 第一個想統治其他人的人在想什麼,Sun Nov  7 03:28:09 2021
9,0,9,ayasesayuki (綾瀨紗雪),Re,Sun Nov  7 03:06:01 2021
3,0,3,koko0123 (KoKo),[問卦] 晚上附近很吵有家暴的聲音怎麼處理?,Sun Nov  7 04:13:21 2021
2,2,0,bra6617 (),[問卦] 屬虎明年犯太歲,Sun Nov  7 01:29:12 2021
8,1,7,qwqwaas (MADE),[問卦] 為什麼吃士力架牙齒會痛?,Sat Nov  6 22:29:41 2021
1,1,0,GivemeApen (走林森北路回家),Re,Sat Nov  6 21:32:36 2021
1,2,-1,chubby31190 (Uaena),[問卦] 為什麼北部無感的地震就有噓 有感才推爆,Sat Nov  6 22:29:01 2021
3,1,2,rizzo123 (阿烙),Re,Sat Nov  6 21:44:37 2021
14,1,13,herbert0716 ((っ・ω・)っ),[問卦] 有沒有北條的八卦,Sat Nov  6 20:53:57 2021
5,2,3,kopuck (派翠克星星),[問卦] 啊 啊啊 啊啊啊啊啊啊 要怎麼啊才好聽,Sat Nov  6 21:12:52 2021
3,0,3,hrma (資深象迷),[問卦] 輕軌飆車可以多快？？？,Sun Nov  7 08:27:30 2021
75,8,67,Su22 (裝配匠),[新聞] 中國糧荒恐懼！多城市爆搶購潮 民眾在超,Sat Nov  6 23:55:11 2021
4,1,3,kinjk01 (小白),[問卦] 聖誕節前沒交女友會單身一輩子？,Sun Nov  7 01:36:37 2021
13,7,6,howard1991 (小旻),[問卦]我是不是被坑了,Sun Nov  7 01:58:25 2021
5,4,1,ptttpt (ptttpt),[問卦] 白襯衫穿有顏色奶罩的女生是不是都故意？,Sun Nov  7 00:58:10 2021
6,3,3,LukeSkywaker (路克天醒者),[問卦] 臥底與警司頂樓會面被發現，警司竟這樣做,Sun Nov  7 01:49:12 2021
0,1,-1,longyin (龍吟很難嗎？為什麼),Re,Sun Nov  7 07:58:38 2021
10,3,7,sploo (阿鑫),[問卦] 除了戰爭和天災，房價有機會跌嗎。,Sun Nov  7 07:19:28 2021
6,0,6,FA88124 (超弩級☆肥宅),[問卦] 可以文字說明硬要打電話的人是什麼心態,Sat Nov  6 21:51:28 2021
140,37,103,Aqqqa (Aqqqa),[新聞] 今到貨AZ效期到月底 藍委：沒疫苗荒為何,Sun Nov  7 00:01:22 2021
6,10,-4,monine (),[新聞] 大陸對台促統 由綿力轉強力,Sun Nov  7 07:25:50 2021
6,1,5,koy89202 (Jie),[問卦] 「新」斗六夜市？,Sat Nov  6 23:00:25 2021
4,2,2,chirex (沒有銅鋰鋅),[問卦] 台灣跟中國脫口秀顏值天花板誰比較頂？,Sat Nov  6 23:15:25 2021
31,5,26,sakeya (薩琪亞),[問卦] EDG奪冠，中國人卻做出無法理解的行為,Sun Nov  7 05:50:55 2021
27,16,11,victor87710 (星詠東方廚),[新聞] 噴3萬8+扣照…重機高速壓車過彎吃紅單 「,Sun Nov  7 07:51:17 2021
6,2,4,HDSM (Love Not Change  O'_'O),[問卦] 有肥宅戒飲料成功過嗎？,Sat Nov  6 22:06:16 2021
6,0,6,toy812 (EverQuest),[問卦] 立冬早餐吃這樣還行嗎？,Sun Nov  7 08:28:28 2021
5,0,5,Nodens (大車駕訓班 榮譽教練),[問卦] 哪個遊樂園衣服最容易濕?,Sun Nov  7 00:40:19 2021
8,0,8,"passing (0""_""0)",[問卦] 房價真的打不得嗎?,Sun Nov  7 00:25:35 2021
3,3,0,deeeplove (巴達獸 可愛d(`･∀･)b),[問卦] 花錢買雲端硬碟有人資料不見過嗎？,Sat Nov  6 23:57:57 2021
56,4,52,saufu08 (saufu),[問卦] 天天有攻台新聞？台灣人還是無感吧？,Sat Nov  6 21:16:14 2021
5,4,1,mytaiwan (轉角遇到困難),[問卦] 唐綺陽也上疾管署廣告,Sat Nov  6 22:12:29 2021
11,2,9,iphone55566 (哀鳳五),[新聞] 休士頓音樂祭樂迷太興奮 推擠、踩踏釀至,Sun Nov  7 02:57:40 2021
9,1,8,Articuno (水噹噹),[新聞] 海底撈股價暴跌 年底前擬關店約300家,Sat Nov  6 21:41:14 2021
23,3,20,b1b2b3b4 (lemon),[問卦] 為什麼開超跑腰會痛?,Sat Nov  6 23:26:07 2021
9,7,2,serenitymice (肥肥),[問卦] 城田優算帥哥嗎？,Sat Nov  6 21:06:32 2021
2,1,1,WAXNSIM (【本人所發必為廢文】),"[問卦] 醜男美女配婚姻,484老公有錢不然就gg大？",Sat Nov  6 21:43:58 2021
4,2,2,AMDMARSHAL (真好時間真多),[問卦] KHAN去當兵會被怎麼霸凌,Sun Nov  7 01:08:35 2021
187,63,124,JKGOOD (Dont QQ),[新聞] 快訊 史上最尷尬 OZI拿金音獎白高興一場,Sat Nov  6 23:12:49 2021
2,1,1,oinmrr (南崁半仙哥),[問卦] 欸欸，為何大排長榮都沒在更新了,Sun Nov  7 01:01:07 2021
4,0,4,CuLiZn5566 (同理心5566),Re,Sun Nov  7 02:15:22 2021
1,1,0,AKS8158 (車がほしいです),[問卦] 臭豆腐到底好不好吃,Sat Nov  6 20:43:56 2021
11,1,10,chen0625 (PTT47),[問卦]即期品要打幾折才會買？,Sun Nov  7 00:29:21 2021
5,1,4,gs1 (2007/1/4),Re,Sat Nov  6 20:56:26 2021
34,3,31,piliamdamd (ppw),[問卦] 這樣的高利貸怎麼有人借得下去?,Sat Nov  6 22:39:57 2021
2,0,2,lianpig5566 (家庭教師殺手里包恩),Re,Sat Nov  6 23:36:03 2021
2,0,2,onetwogo (中國訊息報告工(正確版)),Re,Sat Nov  6 21:22:22 2021
28,3,25,uiiuiiu (晴),[新聞] 木柵「少女命案」沉冤27年　檢突收匿名信,Sun Nov  7 08:02:09 2021
97,15,82,losel (),[新聞] 2樓變6樓！議員父遭控違建　「隔分租套房,Sat Nov  6 20:59:16 2021
10,3,7,deitly (一萬光年的愛情),[問卦] 台女為何這麽愛健身房,Sun Nov  7 01:10:16 2021
0,3,-3,lolic (白蝙蝠巴比特),[問卦] 想你 醒在午夜零點零三分  你會去哪裡　,Sun Nov  7 00:03:07 2021
8,6,2,sos976431 (淡江金城武),[問卦] 如果是兩人一鍋還會被罵嗎?,Sat Nov  6 22:37:10 2021
3,0,3,gv390 (我討厭我喜歡妳),Re,Sun Nov  7 01:49:24 2021
5,1,4,weber18767 (Cine 21),[問卦] 女生取英文名Gigi有什麼含義？,Sat Nov  6 21:51:19 2021
8,1,7,w510048 (黨的恩情比山高),[問卦] 為何每到要過年都會有人幻想表妹堂妹呢??,Sat Nov  6 21:12:57 2021
4,2,2,GraceMa (我喜歡騎馬),[問卦] 為什麼史萊哲林一直出問題,Sun Nov  7 00:11:44 2021
3,2,1,dj4 (^^),Re,Sun Nov  7 00:53:52 2021
11,4,7,zoriyah (\^O^/BA),[問卦] 請問這是IPhone的什麼標示？,Sat Nov  6 23:58:54 2021
3,1,2,teeheehee (軟尾拋拋翔(′・ω・`)),[問卦] 看見別人失敗就很爽是人類的天性嗎？,Sun Nov  7 08:26:45 2021
4,0,4,jokerming847 (God of Mischief),[問卦] 欸！吉娃娃知道自己很機掰嗎？,Sun Nov  7 04:01:44 2021
3,2,1,ivorysoap (ivorysoap),[問卦] 眼鏡度數不能配剛剛好是真的嗎？,Sun Nov  7 02:10:03 2021
7,10,-3,NARUTO (鳴人),[問卦]臺鐵努力拚立體化 淡海輕軌為什麼蓋平面？,Sat Nov  6 20:56:04 2021
18,5,13,anson8901 (邦寶退散),[問卦] 對面有什麼徵兆 台灣就會開始戒嚴？,Sun Nov  7 00:02:14 2021
8,0,8,amy93 (silence),[新聞] 飛機迫降西班牙小島20人趁機逃跑 警方捉,Sun Nov  7 05:28:23 2021
66,3,63,ptt987654321 (大谷躺平),[新聞] 罕見！11月台電降壓3％ 秋冬鬧缺電 台電,Sun Nov  7 08:24:37 2021
5,5,0,algebraic (algebraic),[問卦] 被學長抓去扛,Sat Nov  6 21:36:49 2021
12,2,10,taiwaneye (愛呆丸),[問卦] 為什麼口罩上要用一顆扣子？,Sun Nov  7 08:15:12 2021
0,0,0,oylq2000 (oylq2000),[問卦] 有沒有如何暗示愛意的八卦？,Sun Nov  7 08:59:57 2021
3,2,1,yenwang (孤狼),Re,Sun Nov  7 02:00:48 2021
6,20,-14,shinmoner (WISDOM),[新聞] 蘇貞昌：美國人很氣 台灣怎進CPTPP？,Sun Nov  7 00:41:58 2021
8,0,8,liang691206 (liang691206),Re,Sun Nov  7 01:48:50 2021
8,1,7,a828203 (),[新聞] 太平間收到91具遺體！獅子山油罐車首都爆,Sat Nov  6 21:29:59 2021
8,1,7,NightStick (龐德任),[問卦] 台男把妹除了討好還有什麼？,Sat Nov  6 23:48:38 2021
6,0,6,YU0121 (愛玉冰™),[問卦] 有什麼東西單售很便宜 變成模組就很貴？,Sat Nov  6 21:54:54 2021
10,0,10,bbob (小海),[問卦] 台中的豬腳店最頂的是阿水師嗎？,Sun Nov  7 00:13:14 2021
8,1,7,GrimmNotes (格林童話),[問卦] 被化骨綿掌打到懶叫會怎麼樣,Sun Nov  7 00:09:20 2021
16,0,16,yofa (YoFa),[問卦] 四十歲存款沒有千萬很魯嗎？,Sun Nov  7 08:46:22 2021
2,0,2,season2011 (),Re,Sat Nov  6 22:31:10 2021
5,2,3,TDOO (我最可愛),[問卦] 原來有綠色情人節？,Sun Nov  7 08:08:52 2021
2,0,2,liang691206 (liang691206),[問卦] 滯台中國人看到台獨通緝犯怎麼處理？,Sun Nov  7 02:30:01 2021
25,5,20,GoogleTaiwan (Hi),[問卦] 為什麼南韓打不贏北韓?,Sat Nov  6 23:36:30 2021
4,2,2,GGinler (69G4),[問卦] 朋友找我看老闆的行車記錄器,Sat Nov  6 21:14:32 2021
5,3,2,waterblue798 (健達繽紛樂),[問卦] 為什麼最強奶媽FB限動都是18禁網址？,Sat Nov  6 21:31:58 2021
6,3,3,app325 (艾波),[問卦] 資工系畢業不會寫程式的人多嗎？,Sun Nov  7 02:09:50 2021
1,3,-2,EVEA (新試劑扶英戰士),[問卦] 降魔尊者會佈什麼陣法讓「鄉民先死一半」,Sun Nov  7 01:52:18 2021
35,14,21,ptt9999 (ptt999),[新聞] 巴奈奪評審團獎氣被大陸欺負 譙年輕人不,Sun Nov  7 00:36:12 2021
7,32,-25,b1b2b3b4 (lemon),[新聞] 汪小菲突正名「我不叫汪小菲」　大S早知,Sat Nov  6 23:03:36 2021
2,0,2,trylin (電鈴怪客),[問卦] 智英這麼可愛為什麼要死掉？,Sun Nov  7 03:00:16 2021
10,8,2,Zoxge (Zoxge),[問卦] 被政治激進女封鎖怎麼辦？,Sat Nov  6 23:32:09 2021
16,4,12,pushxuman (推噓俠),[問卦] 女朋友又不分手 怎麼慶祝才內行,Sun Nov  7 02:11:44 2021
5,2,3,EricTCartman (阿ㄆㄧㄚˇ),[問卦] 捐款給非營利組織 有幾成是在付薪水？,Sun Nov  7 00:05:47 2021
57,20,37,hkr91511208 (梅鴿),[爆卦] EDG電子競技俱樂部 S11世界冠軍,Sun Nov  7 01:01:56 2021
5,2,3,tonylolz (我是基德),[問卦] 韓粉是不是輸不起?,Sun Nov  7 01:15:30 2021
5,0,5,freshguy (懷念不如相見),[問卦] 有沒有中國武術的八卦？,Sat Nov  6 23:46:00 2021
54,36,18,novashine (支那賤畜、六四、塔綠斑),[新聞] 陳柏惟深情告白選民：你嫌我草根痞子,Sun Nov  7 07:25:58 2021
16,2,14,kukulee (),[新聞] 《2分之一強》金炳秀「一天跑全台約3女」,Sun Nov  7 08:38:00 2021
59,3,56,derekhsu (浪人47之華麗的天下無雙),[爆卦] 疫情整理:德超英中歐慘 越南反彈南美新憂,Sat Nov  6 22:57:08 2021
7,0,7,ClownT (克朗),[問卦] 跟過明翰3C事件的人都幾歲了？,Sat Nov  6 23:56:08 2021
8,0,8,keel90135 (尼可),[問卦] 喜宴政治人物不請自來怎辦?,Sat Nov  6 22:10:12 2021
6,0,6,IslamicState (伊斯蘭國-不亂砍頭),[問卦] 幾歲跳街舞會被嫌老,Sat Nov  6 23:06:31 2021
55,10,45,haha98 (口合口合九十八),[新聞] 低消引糾紛! 吃鍋被老闆嗆「白吃白喝」客,Sat Nov  6 23:16:52 2021
55,6,49,aertina (Aertina),[問卦] 台灣這次會買輝瑞口服藥嗎,Sat Nov  6 22:14:12 2021
5,2,3,FAYeeeeeeee (Fay),[問卦] 全天下甲甲都會犯的錯是什麼？,Sun Nov  7 03:00:08 2021
13,1,12,newsted5566 (NEWSTED5566(亂劣我文)),[問卦] 文化路郭家和阿霞大家比較喜歡哪一間阿？,Sat Nov  6 21:47:57 2021
0,1,-1,yangzy (亞瑟),[問卦] 得罪美國跟世界的超前部署做了嗎？,Sun Nov  7 00:17:02 2021
17,20,-3,assassinASHE (幹古專用帳號),[問卦] 你們憑啥看不起同性戀 講話 我叫你們講話,Sun Nov  7 05:24:30 2021
3,0,3,leopika (萊奧˙波卡),[問卦] 無線充電板要買哪個牌子,Sat Nov  6 23:26:14 2021
5,2,3,yamahabbs (老ㄟ),[問卦] 有遇過會抖腳的女生嗎,Sat Nov  6 22:42:23 2021
22,2,20,ms0286415 (ms0286415),[問卦] Pchome的介面是不是亂到根本不想看??,Sun Nov  7 03:07:31 2021
6,2,4,YEEman (江冠德),[問卦] 吉娃娃是怎麼不被天擇淘汰的?,Sat Nov  6 23:12:44 2021
7,1,6,nobel777 (),[問卦] 肥宅都怎麼應付恐男的女生？,Sun Nov  7 08:50:49 2021
3,3,0,DCARDNOBRAIN (低能卡),[問卦] 快樂兒童餐沒有兒童該客訴嗎,Sat Nov  6 22:18:45 2021
9,3,6,cp296633 (Joey),[問卦] 加碼券最廢的是啥？,Sun Nov  7 01:09:33 2021
4,0,4,Alertme (-.-),Re,Sun Nov  7 00:00:11 2021
4,0,4,a6000200 (aa),[問卦] 有crypto的八卦嗎？,Sun Nov  7 02:45:19 2021
59,16,43,anger312143 (anger),[問卦] 工程師社會地位好像很低？,Sun Nov  7 02:18:29 2021
1,0,1,WAXNSIM (【本人所發必為廢文】),Re,Sat Nov  6 22:46:25 2021
2,1,1,GETpoint (擲雷爆卦),[問卦] 德國鐵路也發生隨機殺人事件？,Sat Nov  6 21:33:43 2021
16,2,14,yushenglu (我愛莊小米),[問卦]黑人陳建州代表作是?,Sun Nov  7 07:36:27 2021
3,0,3,tomer (卯月影),Re,Sat Nov  6 21:41:20 2021
4,0,4,ludohsiao (陸星材),[問卦] 我喜歡你 也喜歡我的機率,Sun Nov  7 04:13:51 2021
7,1,6,GETpoint (擲雷爆卦),[問卦] 這隻鯊魚是吃了什麼？,Sat Nov  6 22:02:11 2021
5,8,-3,redDest (紅紅),[問卦] 偷吃女同學的大便算侵占嗎？,Sun Nov  7 01:20:46 2021
6,0,6,kyjita (黑田MarkII),[新聞] 邀王惠美參加喬友追思會吃閉門羹 殉職消,Sun Nov  7 07:33:07 2021
15,2,13,GoogleTaiwan (Hi),[問卦] 為什麼魏國會輸給晉國?,Sat Nov  6 23:51:45 2021
34,1,33,kicker (kicker),[新聞] 繼採購默沙東抗COVID口服藥後 南韓再採購,Sat Nov  6 22:38:27 2021
8,0,8,jajujo (尚未通過認證),[問卦] 咖啡算飲料嗎,Sat Nov  6 22:19:33 2021
23,3,20,a828203 (),[問卦] 核四沒燃料棒，要怎麼運作?,Sat Nov  6 21:47:30 2021
2,2,0,EVEA (新試劑扶英戰士),[問卦] 立冬叫雞會「招來不幸」嗎???,Sun Nov  7 01:29:35 2021
5,2,3,a09651238 (可口美味好滋味),[爆卦] 睽違九年！！！台灣選手再度在lol得冠,Sun Nov  7 01:06:13 2021
1,2,-1,dk27go (可我未曾見過海洋),[問卦]  現在什麼最潮?,Sun Nov  7 01:33:07 2021
5,0,5,KasmirLo (科科科~),[問卦] 華格納哪部最頂,Sat Nov  6 21:55:44 2021
8,1,7,cailon (我不一定是我!),[問卦] 高義,Sat Nov  6 22:53:18 2021
10,2,8,k99t (聖誕小雞),[問卦] 有沒有大家機車都用哪一牌子的機油？,Sat Nov  6 23:44:44 2021
5,3,2,gotopark (無限風光在險峰),[問卦] 同事上班沒做事都在團購，會不爽嗎?,Sat Nov  6 21:30:39 2021
9,2,7,mytaiwan (轉角遇到困難),[新聞] 不滿分手！女持刀攻擊男友遭砍濺血逃命 ,Sat Nov  6 21:57:07 2021
5,0,5,queenp (A.N.推推),[問卦] 有人知道這是什麼黃色蛾蛾？,Sun Nov  7 07:28:09 2021
4,1,3,hugh509 ((0_ 0)),[問卦] Facebook總公司幹嘛不改叫hololive?,Sat Nov  6 23:55:17 2021
4,1,3,gerogexpg (Das Internetz),Re,Sat Nov  6 21:14:06 2021
1,0,1,clark2644 (気持ちが悪い),[問卦] 怎麼跟設計師溝通燙髮的八卦？？,Sat Nov  6 23:54:05 2021
2,11,-9,chieftaincy (回歸之路),Re,Sun Nov  7 01:45:43 2021
9,2,7,clearday (天氣晴！),[問卦] 論文的實驗別人都做過了怎麼辦,Sat Nov  6 21:46:24 2021
4,4,0,luxurygenius (嘻),[問卦] 幹油價也太貴,Sat Nov  6 22:49:56 2021
2,1,1,Yorksa (約克夏),[問卦] 電影中的黑白配,Sun Nov  7 01:55:42 2021
6,4,2,lichuer (Z揪兒),[問卦] 輪夜班之後發現皮膚變好身體變健康了?,Sat Nov  6 23:13:41 2021
1,1,0,O300 (歐三百),[問卦] 早餐吃鐵板麵配咖啡是財富自由了嗎,Sun Nov  7 08:50:36 2021
1,3,-2,mikemagic88 (Mikemagic88),[問卦] 減脂有很難?,Sun Nov  7 07:56:46 2021
5,0,5,shesheder (Alita 99),[問卦] 瞬間收視率??,Sat Nov  6 21:22:58 2021
5,1,4,Neverfor (八卦蟑螂),[問卦] 今年電費爆增的八卦,Sun Nov  7 07:43:02 2021
7,0,7,AKATSKI ( ),[問卦] 台灣很多瞎子在騎車??,Sat Nov  6 21:13:52 2021
1,4,-3,mikemagic88 (Mikemagic88),Re,Sun Nov  7 01:37:21 2021
7,0,7,elibra01 (飛行荷蘭人),Re,Sat Nov  6 20:49:56 2021
2,1,1,bobyhsu (專業收費代洗文章),[問卦] 牛郎支女？,Sun Nov  7 07:55:49 2021
5,1,4,kohanchen (kohanchen),[問卦] 會不自覺翹小拇指怎麼辦？,Sun Nov  7 08:48:20 2021
3,2,1,casco5566 (卡斯摳),[問卦] 辦公室有人放監視器,Sat Nov  6 21:08:22 2021
2,2,0,Paul1021 (胡迪),[問卦] 男生英文強在正妹心中有加分嗎,Sat Nov  6 23:50:09 2021
0,0,0,sofaly (沙發椅),Re,Sat Nov  6 21:17:34 2021
5,1,4,gn01982027 (夢露是個好樂團),[問卦] 天堂W怎跟天堂M畫面不一樣?,Sun Nov  7 00:17:08 2021
9,2,7,facebookig (魯蛇臉書),[爆卦] 好心提醒未開大燈被誤認逼車,Sun Nov  7 01:49:37 2021
5,0,5,a49725119 (cc),[問卦] 有沒有顏志琳的八卦？,Sat Nov  6 23:00:02 2021
12,1,11,saiulbb (#KEEP MLB GREAT!),[問卦] 馬斯克PO曹植《七步詩》那郭董會PO甚麼？,Sat Nov  6 23:39:36 2021
3,1,2,railway123 (railway123),[問卦] 司法人員可以自己發新聞稿嗎？,Sat Nov  6 23:25:26 2021
27,0,27,Number87 (人畜無害),[問卦]日本的書包怎麼這麼貴,Sat Nov  6 22:22:07 2021
2,3,-1,kkkkouo (工具人001),[問卦] 實聯制掃條碼是為了儀式感嗎??,Sat Nov  6 21:39:09 2021
26,7,19,arsonlolita (蘿莉塔大魔王←男的勿約),[公告] 宣導 非花邊政治類新聞請至專板張貼,Fri Nov  5 15:17:26 2021
156,14,142,raxxar82 ( ),Re,Sat Nov  6 21:03:11 2021
7,3,4,JUNOCARE (陽光！！),[問卦] 咖啡店的店長到底恨不恨坐一整天的客人,Sun Nov  7 01:06:59 2021
4,0,4,loadingN (sarsaparilla),[問卦] 有沒有湯皇帝的八卦？,Sat Nov  6 21:34:54 2021
4,5,-1,dilson (中肯的話通常不好聽懂嗎),[問卦] 開戰第二天要做什麼？有八卦嗎？,Sat Nov  6 20:55:38 2021
4,0,4,bra6617 (),[問卦] 邱瘋子當年怎麼不認真去救黃百韜?,Sun Nov  7 00:24:39 2021
5,1,4,RoroyaZoro (最賤．問天譴),Re,Sun Nov  7 07:44:28 2021
6,2,4,butten986 (白色的惡魔),Re,Sat Nov  6 21:35:36 2021
7,1,6,crimson11 (crimson),[問卦] 黃金神威的北海道朝聖之旅怎麼安排？,Sat Nov  6 22:31:30 2021
6,3,3,slovea (廢物文組傳產學徒),[問卦] 伍佰為什麼不親自去高雄流音拍宣傳片,Sun Nov  7 03:15:55 2021
9,2,7,Qoo2222 (Qoo2222),Re,Sat Nov  6 23:18:37 2021
4,2,2,Gossipimg (-w-),[問卦] 說真的，捐錢給窮苦國家有屁用，都在貪汙,Sat Nov  6 23:59:01 2021
4,3,1,jospa (jospa),[問卦] 搶註到Snoopy這隻帳號能幹嘛?!,Sun Nov  7 00:51:29 2021
6,9,-3,smreignqrop (Mr.齊),[問卦] 請問，肥宅從93攻進瘦到65公斤有加分嗎?,Sun Nov  7 00:22:22 2021
5,1,4,hushiang (我練功發自真心),[問卦] 永恆族沒找鼻子演是不是敗筆？,Sat Nov  6 23:15:59 2021
45,9,36,Usayhiisayha (*＠你說Hi 我說ㄏㄚˋ＠*),[問卦] 幹你娘 永恆族到底是什麼糞？,Sun Nov  7 00:35:51 2021
12,0,12,showmaker (神偷),[問卦] 有沒有輸比賽又被桶的卦,Sun Nov  7 03:43:20 2021
1,4,-3,zxc881230 (神槍手打手槍神),[問卦] 認真問 低卡上面怎麼一堆千百萬幣神,Sun Nov  7 01:56:27 2021
8,10,-2,assassinASHE (幹古專用帳號),[問卦] 閱覽室抱女童 會很變態嗎??,Sun Nov  7 06:59:33 2021
10,3,7,laidos (道士),[問卦] 孔明、孫臏、孫武 、鬼谷子兵法妙計誰高,Sat Nov  6 23:07:44 2021
5,0,5,joster9527 (賈斯特),[問卦] 哇欸麻吉底堆？,Sat Nov  6 22:35:05 2021
19,3,16,poppyvampire ( ),[問卦] 台灣如果拍魷魚遊戲會用哪個小吃?,Sat Nov  6 22:33:44 2021
1,0,1,weeklyquiz (腦洞烏托邦小烏第一),[問卦] 冒充金城武的鄉民會有女孩兒嗎,Sun Nov  7 08:29:59 2021
7,1,6,LYS5566 (明燈❺❺❻❻),Re,Sat Nov  6 21:56:27 2021
6,1,5,NightStick (龐德任),[問卦] 妹子身上一片刺青會倒陽嗎？,Sun Nov  7 01:21:38 2021
3,0,3,gogomercury (gogomercury),[問卦] 台灣司法大勝香港司法？,Sat Nov  6 23:12:13 2021
7,2,5,kasumi5566 (霞),[問卦] 白蔥糖不戴手套用手搓有人敢吃？,Sat Nov  6 22:36:25 2021
8,1,7,ck6fuz516 (不是一就是二),[問卦] 中研院研究助理月薪34K?,Sun Nov  7 00:55:47 2021
5,1,4,B9830226 (czcchi),[問卦] 野餐帶什麼食物才內行,Sat Nov  6 21:15:52 2021
12,3,9,NicoToscani (女友很像三上悠亞 ^^),[問卦] 北車上公廁，看到大便間有兩個男的?,Sun Nov  7 02:37:03 2021
4,3,1,B0858B (),[新聞] 台灣哪個藝人零負評？釣出羅志祥本尊11字,Sun Nov  7 01:59:54 2021
0,0,0,todao (心裡有數),[問卦] 我的故事已經無看你,Sun Nov  7 00:57:12 2021
5,2,3,YoungOG (OG),"[問卦] 外國人穿POLO衫,為什麼會把扣子扣滿?",Sat Nov  6 21:57:07 2021
10,1,9,dodo52woman (嘟嘟左右衛門),[問卦] 還有人在買品客洋芋片嗎？,Sat Nov  6 23:29:48 2021
4,1,3,uselesspenis (無用陰莖),[問卦] ipad mini pro air 無印 怎麼分阿,Sat Nov  6 23:50:29 2021
18,3,15,yaya (喔耶比),[新聞]高雄有民眾持空氣槍打綠鬣蜥 違反槍砲彈藥,Sat Nov  6 23:56:08 2021
34,4,30,rsreason (RSR),[新聞] 美國很生氣？馬英九反問蘇貞昌：莫名其妙、幹麻生氣,Sun Nov  7 08:04:18 2021
8,10,-2,MosDonalds (薛丁格的速食店),[問卦] 為什麼台女都那麼愛錢？,Sat Nov  6 22:59:11 2021
11,6,5,ivorysoap (ivorysoap),[問卦] 買到的AZ是即期品 那有比較便宜嗎？,Sun Nov  7 01:50:54 2021
3,1,2,"god46 (大家好,我是JayJay林俊傑)",[問卦] 真相讓人自由嗎？,Sun Nov  7 00:24:55 2021
9,0,9,iamshana (CANINE力集中在一些重要S),[問卦] 北屯最頂的美食是什麼呀？,Sat Nov  6 23:52:47 2021
42,8,34,emperor (派蘿派蘿得第一),[問卦] 台灣家長敢讓小一自己上學嗎?,Sat Nov  6 22:39:03 2021
5,1,4,OPPAISuki (OPPAISuki),[問卦] 金音獎 頒錯 不尷尬吧??,Sun Nov  7 00:28:12 2021
13,4,9,stuj9019 (肥宅好吃 ^Q^),[問卦] 要開放高端仔混打了沒,Sat Nov  6 23:04:51 2021
33,5,28,miss80423 (自宅警備員),[問卦] 國考如果好幾年沒上外出怎麼介紹自己,Sat Nov  6 23:33:59 2021
0,0,0,zxcgod69 (瀛),[新聞] 核能改列綠能？法點頭 德反對,Sun Nov  7 08:58:07 2021
8,2,6,ccugoo (小麥),[新聞] 清華大學新任校長 高為元獲選,Sat Nov  6 23:41:23 2021
6,1,5,Ommmmmm5566 (有人責備我們不夠深入),[問卦] 台灣如果要組自殺突擊隊要招募誰,Sat Nov  6 22:04:40 2021
5,4,1,EricTCartman (阿ㄆㄧㄚˇ),[問卦] 為什麼核能＝核四？,Sat Nov  6 23:39:57 2021
7,2,5,kerorobear (解放君愛肛交),[問卦] 有TheNewsLens關鍵評論網的八卦嗎,Sat Nov  6 22:57:34 2021
9,7,2,iamshiba ((  ・ω・`)),[問卦] 早餐店奶茶真的沒有食安問題嗎,Sat Nov  6 23:24:23 2021
4,0,4,NARUTO (鳴人),Re,Sat Nov  6 23:03:34 2021
143,6,137,t020202 (t020202),[協尋] 尋貓啟示,Fri Nov  5 16:17:18 2021
9,1,8,k99t (聖誕小雞),[問卦] 有沒有該怎麼製造出一個話題的八卦呢？,Sat Nov  6 23:53:29 2021
0,1,-1,skn60694 (入聲),[問卦] 我的冬天 就要來了?,Sat Nov  6 23:29:49 2021
